W W W W W W W W
W - - T - - - W
W - - - - - - W
W - - - - - - W
W - - - - - - W
W - - - - - - W
W - - - - - - W
W - - - - - - W
W - - - P - - W
W - - - - - - W
W - - - - - - W
W W W W W W W W