W W W W W W W W W W W W W W W W W W W W
W - - - - W - E - - - W G - G - - - - W
W - - - - W - - - - - W - - - - - - - W
W - - - - W - - - - - W - - - - - - - W
W - - - - W W W D W W W - - - - - - - W
W - - - - - - - - - - R - - - - - - - W
W G - - - - - - - - - - - - - - - - P W
W - - - - - - - - - - - - - - - - - - W
W - - - - - - - - - - - - - - - - - - W
W - - - - R - - - - - - - - - - - - - W
W K - - - - R - - - - - - - - - - - - W
W W W W W W W W W W W W W W W W W W W W